Adolfo Vargas Villena	Loreto
Alberto Acuña Fernández	Loreto
Aníbal Muñoz Mendoza	Loreto
Carlos Martín Torrejón Ríos	Loreto
Eder Eli Aguilar Rojas	Loreto
Eduardo Ferreyra Tello	Loreto
Edwin Gabino Zeballos Bazan	Loreto
Elard Calli Araca	Loreto
Eleodoro Shupingahua Chota	Loreto
Hector Herbozo Olortegui	Loreto
Hernan de Jesus Elespuru Bastos	Loreto
Jhonny Flores Chávez	Loreto
Jimy Flores Pacaya	Loreto
Jorge Lopez Vasquez	Loreto
José Nicasio Armas Montes	Loreto
Juan Rios Sevillano	Loreto
Luis Alberto Panduro Rengifo	Loreto
Maria Clelia Guerra Napanga	Loreto
Mauro Raúl Argumedo Castillo	Loreto
Miguel Mestanza Montoya	Loreto
Nicolás Jorge Hernández Hernández	Loreto
Rafael Walter García Dávila	Loreto
Raul Tejedo Huaman	Loreto
Segundo Mercedes Pinillos Reyes	Loreto
Victor Manuel Antonioli Levano	Loreto
Wilbert Cabello Quispe	Loreto
María Gambini Alvarez	Tumbes
Angel Espinoza Pelaez	Piura
Jorge Sánchez López	Piura
José Bernabe Gutierrez	Piura
José Nizama Valverde	Piura
Luis Enrique Ramos Correa	Piura
Luis More Ayala	Piura
Luis Saavedra Juárez (Callao)	Piura
Marino Purizaca Amaya	Piura
Paul Pachas Yataco	Piura
Salvador Oswldo Hoyos Cardo	Piura
Walter Vegas Olaya	Piura
Enrique Marroquín Osorio	Cajamarca
Félix Herrera Méndez	Cajamarca
Jaime Moreno Alberca	Cajamarca
Veronica Celis Rios	Cajamarca
Erland Rodas Diaz	Amazonas
Luis Perez de Miguel	Amazonas
Andres Eduardo Gomez de la Torre Campos	Lambayeque
Angel Rodriguez Castro	Lambayeque
Aurelio Barboza Bancayan	Lambayeque
Ciro Sagástegui León	Lambayeque
Fausto Diaz Tantalean	Lambayeque
Jose Agustin Cabrera Ramirez	Lambayeque
María Solis Martínez	Lambayeque
Marino Alarcón Solano	Lambayeque
Neill Moises Roman Flores	Lambayeque
Ricardo Serrato Maza	Lambayeque
Rosa Elena Cortez Morantes	Lambayeque
Simon Escobar Alvarez	Lambayeque
Steve Motta del Castillo (Chiclayo)	Lambayeque
Teobaldo Valdez Cieza	Lambayeque
Alfonso Zuñiga Goicochea	La Libertad
Domingo Agreda Avalos	La Libertad
Gabriel Quispe Valencia	La Libertad
Javier Vasquez Rumiche	La Libertad
Jesus Gonzáles Cacho	La Libertad
Julio Elmer Bardales Esparza	La Libertad
Luis Perez Rodriguez	La Libertad
Manuel Urbina Obando	La Libertad
Oscar Efraín Ramos Samaniego	La Libertad
Ricardo Shimajuko Bautista	La Libertad
Roger Haro Castillo	La Libertad
Ruben Agustin Diaz Marin	La Libertad
Rudecindo Gutierrez Araujo	La Libertad
Santos Alvarado Agreda	La Libertad
Segundo Perez Nieto	San Martin
Antonio Agreda Ulloa (Huaraz)	Ancash
Antonio Hipolito Machuca Burgos (Chimbote)	Ancash
Johnny Cano Suárez (Chimbote)	Ancash
Luis Serna Lamas (Huaraz)	Ancash
Manuel Aldave Boyd (Chimbote)	Ancash
Miguel Edgar Villavicencio Torres (Chimbote)	Ancash
Romulo Villacaquie Rrojas (Huaraz)	Ancash
Rosa Muchaypiña Rios (Huaraz)	Ancash
Segundo Henry Ypanqui Yupanqui (Chimbote)	Ancash
Agustin Ampuero Flores	Huanuco
Alfredo Tataje Silva	Huanuco
Daniel Oscar Delgado Cornejo	Huanuco
Enrique Tavera Tello	Huanuco
Rosa Rodriguez Castillo	Huanuco
Yuri Condezo Tarazona	Huanuco
Anthony Silva Tananta	Ucayali
Hilario Mendoza Ferrer	Ucayali
Justo German Salas Raymondi	Ucayali
Luis Quintana Verastegui	Ucayali
Neil Alarcón Quispe	Ucayali
Tomas Amayo Lima	Ucayali
Enrique Flores de la Cruz	Pasco
Raul Garrido Llosa	Pasco
Víctor Escajadillo Apestegui	Pasco
Abel Vicharra Arroyo	Lima
Abraham Zavala Stambury	Lima
Alberto Arias Davila	Lima
Alcibiades Capcha Orellana	Lima
Aldo Paliza Ravazzani	Lima
Alejandro Evaristo Guzman Jimenez	Lima
Alfredo Julian Villanes Palacios	Lima
Alfredo Samanamu Marzal	Lima
Andres Granda Alba	Lima
Angel Abel Alcala Pujais	Lima
Ángel Sáenz Yaya	Lima
Arturo Reyes Suarez	Lima
Arturo Segura Alcarraz	Lima
Belisario Salas Torres	Lima
Boris Ernesto Chojeda Cruz (Callao)	Lima
Carlos Castro Farro	Lima
Carlos Chirinos Quispe (Callao)	Lima
Carlos Del Aguila Braithwaite	Lima
Carlos Espiritu Alvarez	Lima
Carlos Mederos Carranza	Lima
Carlos Miranda Ly (Lima-provincias)	Lima
Carmen Alicia Aliaga Salas	Lima
Carolina Dianderas Quispe (Callao)	Lima
Cecilio Zamora Huamán	Lima
Cesar Augusto Sanchez Nolasco	Lima
Cesar Augusto Torres Alcala	Lima
César Fernando Zapata Rojas	Lima
César Jara Baca	Lima
César Julca Dávila	Lima
César Orrego Espinoza (Callao)	Lima
Cesar Poma Mendo	Lima
César Salvador Ulloa (Lima-provincias)	Lima
Christian Rojas Merino	Lima
Cipriano Jesus Paliza	Lima
Conde Contreras Santibañez	Lima
Dacio Agustin Saenz Toscano	Lima
Daniel Gregorio Bazan Blas	Lima
Dante Alania Astete	Lima
Dante Augusto Juan Aranda Ipince	Lima
Dante Castro Chávez (Callao)	Lima
Dario Eugenio Concha Andia	Lima
David Garcìa Melgarejo	Lima
David Moreyra Espichan (Callao)	Lima
David Sanchez Zelaya	Lima
Delia Magdalena Carbajal Ignasio	Lima
Eberth Huaman Cabello	Lima
Edmundo Agustin Neves Gallegos (Lima-provincias)	Lima
Eduardo Carlos Herrera Cotrina	Lima
Eduardo Pachas Napan (Lima Provincias)	Lima
Edwin Cesar Muñoz Martel	Lima
Edwin Francisco Loyola Sulca	Lima
Efrain Vasquez Barreda (Lima-provincias)	Lima
Elder Florida Alvarado	Lima
Elias Izquierdo Bocanegra	Lima
Eliseo Fernandel Pachas Napan (Lima-provincias)	Lima
Esteban Malpartida Contreras	Lima
Felipe Santiago Espinoza Sanchez (Callao)	Lima
Felix Gomez Rumiche	Lima
Fernando Moreno Corzo	Lima
Fidel Velasquez Cruz	Lima
Fidencio Garcia Salazar	Lima
Fortunato Mezarina Trujillo	Lima
Francisco Lossio Iturri	Lima
Gary Poemape Francia (Lima provincias)	Lima
Gerardo Ortega Herrad	Lima
Gilberto Enrique Miranda Ulloa	Lima
Giovani Jaffet Delgado Valdivia	Lima
Guillermo Felipe Wurst Calle	Lima
Hebert Miranda Mejía	Lima
Helga Samatelo Valdivia	Lima
Hernando Amador Capistrano Corcuera	Lima
Hugo Sobrevilla Daniels	Lima
Hugo Villanueva Ayzanoa	Lima
Jaime Eduardo Lock Rojas	Lima
Jaime Gutierrez Ponciano	Lima
Jaime Paulino Cotrina	Lima
Jaime Ricardo Wong Sing	Lima
Jesus Emerson Andia Bravo	Lima
Jesus Poma Claros (Callao)	Lima
Jesús Ponce Flores	Lima
Jesús Ríos Olivares (Callao)	Lima
Jesús Tan Kuong	Lima
Jesus Ventura Paz	Lima
Johann Butrón Butrón	Lima
Jonny Ricardo Santillan Sanchez	Lima
Jorge Berrios Ricardi (Lima provincias)	Lima
Jorge Casana Bejarano	Lima
Jorge Fernandez Astecker	Lima
Jorge Flores Ferrer (Lima-provincias)	Lima
Jorge Ipanaqué Anastacio	Lima
Jorge Ludeña del Aguila	Lima
Jorge Rodríguez Hilares	Lima
Jorge Santiago Vereau Moreno	Lima
Jorge Washington Reyna Rojas	Lima
Jose Adolfo Fernandez Caycho	Lima
José Chuan Cabrera	Lima
Jose Ernesto Raez Gonzalez	Lima
Jose Eufemio Lora Rodriguez	Lima
Jose Illescas Montesinos	Lima
Jose Julian Mollo Angulo	Lima
Jose Luis Heriberto Vega Linares	Lima
Jose Paredes Abanto	Lima
José Rocillo Valdez	Lima
José Torres Salas	Lima
Juan Anicama Ramirez	Lima
Juan Antonio Gonzales Correa (Callao)	Lima
Juan Caleb Mendieta Carbajal	Lima
Juan Castillo Vargas	Lima
Juan Córdova Rodríguez (Callao)	Lima
Juan Fernando Perez Cardenas	Lima
Juan Francisco Chapoñan Chapoñan (Lima-provincias)	Lima
Juan Francisco Neyra Navarro	Lima
Juan Manuel Noriega Ponce	Lima
Juan Marino Herrera Arias (Lima-provincias)	Lima
Juan Tori Tori	Lima
Juber Flores Llontop	Lima
Julio Aldana Camacho	Lima
Julio Amado Ramirez (Lima provincias)	Lima
Julio Enrique Berrocal Zambrano	Lima
Julio Quintana Leonardo	Lima
Katianna Elizabeth Dolores Baldeon Caqui	Lima
Lenin Chávez Villa	Lima
Leonardo Chirinos Caillagua	Lima
Leoncio Acuña Fernandez (Lima Provincias)	Lima
Lizardo Guillen Oneeglio	Lima
Luis Acosta Sanchez	Lima
Luis Alberto Torres Tamayo	Lima
Luis Angulo Zevallos	Lima
Luis Augusto Coronado Santillan (Callao)	Lima
Luis Changa Arequipeño (Lima provincias)	Lima
Luis Fernando Lucero Melgarejo	Lima
Luis Gastiaburu Pantoja	Lima
Luis Herrera Medrano	Lima
Luis Maldonado Rafaele	Lima
Luis Morales Galarreta	Lima
Luis Saavedra Quiroz	Lima
Luis Sandoval Valiente	Lima
Luis Valdez Marquez	Lima
Manuel Agramonte Gallart	Lima
Manuel Sanchez Aliaga (Lima provincias)	Lima
Marco Bustamante Paredes	Lima
Marcos Canchis de la Cruz	Lima
Marcos Enrique San Miguel Lazaro	Lima
Maria Marquez-Zorrilla Ponce	Lima
Maria Soledad Diaz Boza	Lima
Mariano Ignasio Alarcon Guevara	Lima
Mario Grimaldo Delzo Palomares	Lima
Mario Sovero Torres	Lima
Marvin Cuenca Bejarano	Lima
Max León Pinto (Callao)	Lima
Michael Martin Olaya Ruiz	Lima
Miguel Angel Mejia Roque	Lima
Miguel Armando Castillo Ventura	Lima
Miguel Armando Colmenares Montenegro	Lima
Moises Eduardo Morales Rezza	Lima
Nazario Basurto Sanchez	Lima
Nestor Camarena Peralta	Lima
Octavio Rios Rios	Lima
Oswaldo Pedro Meneses Rivas	Lima
Paul Vera Junchaya (Callao)	Lima
Pavel Cruz Colca	Lima
Pedro Alejandro Milla Velarde	Lima
Pedro Apaza Saravia (Callao)	Lima
Pedro Arellano Coello	Lima
Pedro Bellido Tellez	Lima
Pedro Fernandez Fernandez (Callao)	Lima
Pedro Miguel Vargas Condor	Lima
Pedro Pablo Silva Martel	Lima
Pedro Zevallos Nuñez	Lima
Percy Gregorio Quenta Herrera	Lima
Percy Hugo Vera Pinto Perez	Lima
Peregrino Vargas Sarmiento	Lima
Preyer Huaman Cabello	Lima
Rafael Marmanillo Neyra	Lima
Ramiro Uldarico Lazo Camposano	Lima
Raphael Jose Borregales Calles	Lima
Raul Tello Casanova	Lima
Renan Mejias Diaz	Lima
Rey David Conde Visa	Lima
Ricardo Abel Huamolle Dominguez	Lima
Ridder Lujan Velarde	Lima
Roberto Almora Carbajo	Lima
Roberto Rodriguez Astocondor	Lima
Rodolfo Gonzales Pinedo	Lima
Roger Guerra-Garcia Cueva	Lima
Rolando Arturo Perez Campo	Lima
Rolando Eusebio Ordaya	Lima
Romel Cesar Ticona Salas	Lima
Ruben Villavicencio Ortiz	Lima
Ruth María Gallegos Diaz	Lima
Sandra Giovana Calmet Yumpo	Lima
Santiago Edgard Castro Lizarraga	Lima
Sara Esperanza Zavaleta Rivas	Lima
Silvia Rojas Galindo	Lima
Tirso Ormeño Ardiles	Lima
Ubaldo Marin Balvin	Lima
Victor Aniano Zegarra Montoya	Lima
Victor Baca Romero	Lima
Victor Chang Zegarra	Lima
Víctor Genaro Shion Yhu (Callao)	Lima
Victor Kikuchi Kubota	Lima
Victor Manuel Jesus Buendia Sotelo	Lima
Víctor Ramón Gamarra	Lima
Victor Raul Mena Ochara	Lima
Victor Sanchez Calagua	Lima
Victor Vásquez Villacorta	Lima
Vladimir Cervantes Cavero	Lima
Walter Eddie Leyva Cordova	Lima
Walter Ruitón Atalaya	Lima
Waymer Arnulfo Benites Cerna	Lima
Wilfredo Galvez Rivero	Lima
Manuel Vega Aguilar	Junin
Carlos Manuel Recoba Flores	Ica
Cesar Santiago Muñante Guzman	Ica
Enrique Chau Pérez	Ica
Felix Leodan Campos Canchero	Ica
Guillermo Eusebio Arones Orozco	Ica
Hernando Tataje Briceño	Ica
Jorge Huamani Ramos	Ica
Julián Morón Aparcana	Ica
Lucy Aquije Ramos	Ica
Luis Alberto Chumacero Gallo	Ica
Luis Fernando Matta Nuñez	Ica
Luis Martín Huamancondor Castillo	Ica
Luz Martha Lengua Aguirre	Ica
Manuel Jesus Yataco Torres	Ica
María Tipismana Pasache	Ica
Nicolas Agapito Escribas Alejo	Ica
Walter Huaman Echegaray	Ica
Wenner Paredes Huamani	Ica
Exequiel Benites Tacanga	Huancavelica
Jannet Ayala Ramos	Huancavelica
Jose Luis Aguilar Lagos	Huancavelica
José Vilchez Misayauri	Huancavelica
Miguel Angel Sucapuca Sanchez	Huancavelica
Arcadio Huamani Godoy	Ayacucho
Luis Alberto Zapana Landaeta	Ayacucho
Carlos Alfredo Ayestas La Torre	Apurimac
Edwin Carlos Urquizo Contreras	Apurimac
Hilber Montoya Culquimboz	Apurimac
David Sumerente Torres	Cusco
Eduardo Cayo Palomino	Cusco
Florencio Casilla Mendoza	Cusco
Florentino Alvarez Mamani	Cusco
Henry Tineo Chicoma	Cusco
Javier Lazoriga Sandoval	Cusco
Jose Domingo Nieto Muriel	Cusco
Octavio Darwin Velazco Zegarra	Cusco
Gerardo Pérez Ramírez	Madre de Dios
Alejandro Jose Revilla Mares	Arequipa
Alejandro Talavera Delgado	Arequipa
Carlos Cleeto Torres Salas	Arequipa
Danny Cornejo Zambrano	Arequipa
Efraín Delgado Mendoza	Arequipa
Erick Pacori Fuentes	Arequipa
Eugenio Chirinos Zereceda	Arequipa
Eusebio Nuñez Gutierrez	Arequipa
Federico Sotomayor Campana	Arequipa
Felipe German Cayra Quiroz	Arequipa
Ferdinad de Amat Loza	Arequipa
Fredy Ricardo Valdivia Figueroa	Arequipa
Héctor Corrales Paredes	Arequipa
Hipolito Chaiña Contreras	Arequipa
Jainor Benavente Bellido	Arequipa
José Vásquez Maldonado	Arequipa
Jose Zevallos Rodríguez	Arequipa
Juan Cary Cutipa	Arequipa
Juan Condori Champi	Arequipa
Juan Fernando Morales Revilla	Arequipa
Marco Merma Carpio	Arequipa
Mario Amado Corrales Bustos	Arequipa
Mario Chávez Flores	Arequipa
Midward Benjamin Rocha Ochoa	Arequipa
Oscar Valdivia Cuba	Arequipa
Oswaldo Hualpa Suyo	Arequipa
Pablo Rondon Lozano	Arequipa
Pedro Aragón Benavides	Arequipa
Tatiana Tavera Nalvarte	Arequipa
Victor Carpio Pastrano	Arequipa
Victor Emigdio Chura Ortiz	Arequipa
Víctor Núñez Manrique	Arequipa
Víctor Vela Corrales	Arequipa
Wilfredo Pino Chávez	Arequipa
Ydo Bedregal Calderón	Arequipa
Yuri Mengoa Quintanilla	Arequipa
Edgard Sánchez del Carpio	Puno
Francisco Condori Lipa	Puno
Henry Machaca Tito	Puno
Henry Zevallos Valdez	Puno
Javier Huanca Mamani	Puno
José Irigoyen Arbieto	Puno
Juan Gustavo Paredes Eyzaguirre	Puno
Laura Del Carpio Condori	Puno
Leonidas Zevallos Borda	Puno
Lucio Rodriguez  Melo	Puno
Nilton Barriga Patiño	Puno
Rafael Pandia Prado	Puno
Reinaldo Mejías Canelon	Puno
Ruben Ccapa Chicani	Puno
Rommel Juarez Zevallos	Moquegua
Carlos Villanueva Rodríguez	Tacna
